
& => and

l'arc～en～ciel => l'arc-en-ciel
koяn => korn

◯◯ => 〇〇
○○ => 〇〇

°c=>度c

++ => plusplus
c#=>csharp
#8000=>sharphassen

lovendoя => lovendor

い・ろ・は・す => いろはす

ケ岳 => ヶ岳
ケ丘 => ヶ丘
ケ原 => ヶ原
ケ崎 => ヶ崎
ケ関 => ヶ関
ケ岡 => ヶ岡
ケ坂 => ヶ坂
ケ島 => ヶ島
ケ池 => ヶ池
ケ浜 => ヶ浜
ケ谷 => ヶ谷
ケ峰 => ヶ峰
ケ窪 => ヶ窪
ケ枝 => ヶ枝

idolm@ster => アイドルマスター

へヴィメタル=>ヘヴィメタル
へビメタル=>ヘビメタル
ぺー=>ペー
アダムエロぺ=>アダムエロペ

pokémon => pokemon
∀ガンダム=>ターンaガンダム

de-esser => deesser
